YEAR,MONTH_NUM,FLT_DATE,APT_ICAO,APT_NAME,Departures_IFR,Arrivals_IFR,Total_IFR_Movements
2019,1,2019-01-01,LIPE,Bologna,68,71,139
2019,1,2019-01-02,LIPE,Bologna,95,99,194
2019,1,2019-01-03,LIPE,Bologna,95,93,188
2019,1,2019-01-04,LIPE,Bologna,96,93,189
2019,1,2019-01-05,LIPE,Bologna,82,83,165
2019,1,2019-01-06,LIPE,Bologna,87,90,177
2019,1,2019-01-07,LIPE,Bologna,100,100,200
2019,1,2019-01-08,LIPE,Bologna,86,85,171
2019,1,2019-01-09,LIPE,Bologna,97,96,193
2019,1,2019-01-10,LIPE,Bologna,93,91,184
2019,1,2019-01-11,LIPE,Bologna,85,87,172
2019,1,2019-01-12,LIPE,Bologna,79,75,154
2019,1,2019-01-13,LIPE,Bologna,82,84,166
2019,1,2019-01-14,LIPE,Bologna,97,97,194
2019,1,2019-01-15,LIPE,Bologna,81,81,162
2019,1,2019-01-16,LIPE,Bologna,90,89,179
2019,1,2019-01-17,LIPE,Bologna,89,93,182
2019,1,2019-01-18,LIPE,Bologna,106,105,211
2019,1,2019-01-19,LIPE,Bologna,81,79,160
2019,1,2019-01-20,LIPE,Bologna,88,89,177
2019,1,2019-01-21,LIPE,Bologna,100,99,199
2019,1,2019-01-22,LIPE,Bologna,89,87,176
2019,1,2019-01-23,LIPE,Bologna,91,92,183
2019,1,2019-01-24,LIPE,Bologna,92,91,183
2019,1,2019-01-25,LIPE,Bologna,98,101,199
2019,1,2019-01-26,LIPE,Bologna,79,77,156
2019,1,2019-01-27,LIPE,Bologna,88,89,177
2019,1,2019-01-28,LIPE,Bologna,105,103,208
2019,1,2019-01-29,LIPE,Bologna,86,86,172
2019,1,2019-01-30,LIPE,Bologna,78,85,163
2019,1,2019-01-31,LIPE,Bologna,99,95,194
2019,2,2019-02-01,LIPE,Bologna,100,96,196
2019,2,2019-02-02,LIPE,Bologna,75,76,151
2019,2,2019-02-03,LIPE,Bologna,85,87,172
2019,2,2019-02-04,LIPE,Bologna,103,98,201
2019,2,2019-02-05,LIPE,Bologna,89,91,180
2019,2,2019-02-06,LIPE,Bologna,94,98,192
2019,2,2019-02-07,LIPE,Bologna,101,96,197
2019,2,2019-02-08,LIPE,Bologna,108,110,218
2019,2,2019-02-09,LIPE,Bologna,82,80,162
2019,2,2019-02-10,LIPE,Bologna,83,87,170
2019,2,2019-02-11,LIPE,Bologna,103,100,203
2019,2,2019-02-12,LIPE,Bologna,75,76,151
2019,2,2019-02-13,LIPE,Bologna,91,94,185
2019,2,2019-02-14,LIPE,Bologna,100,104,204
2019,2,2019-02-15,LIPE,Bologna,114,108,222
2019,2,2019-02-16,LIPE,Bologna,84,81,165
2019,2,2019-02-17,LIPE,Bologna,82,86,168
2019,2,2019-02-18,LIPE,Bologna,106,105,211
2019,2,2019-02-19,LIPE,Bologna,93,91,184
2019,2,2019-02-20,LIPE,Bologna,95,95,190
2019,2,2019-02-21,LIPE,Bologna,93,96,189
2019,2,2019-02-22,LIPE,Bologna,100,100,200
2019,2,2019-02-23,LIPE,Bologna,90,88,178
2019,2,2019-02-24,LIPE,Bologna,95,92,187
2019,2,2019-02-25,LIPE,Bologna,101,103,204
2019,2,2019-02-26,LIPE,Bologna,95,95,190
2019,2,2019-02-27,LIPE,Bologna,97,97,194
2019,2,2019-02-28,LIPE,Bologna,94,94,188
2019,3,2019-03-01,LIPE,Bologna,105,113,218
2019,3,2019-03-02,LIPE,Bologna,97,90,187
2019,3,2019-03-03,LIPE,Bologna,89,90,179
2019,3,2019-03-04,LIPE,Bologna,108,110,218
2019,3,2019-03-05,LIPE,Bologna,95,92,187
2019,3,2019-03-06,LIPE,Bologna,95,95,190
2019,3,2019-03-07,LIPE,Bologna,105,107,212
2019,3,2019-03-08,LIPE,Bologna,101,98,199
2019,3,2019-03-09,LIPE,Bologna,89,92,181
2019,3,2019-03-10,LIPE,Bologna,91,90,181
2019,3,2019-03-11,LIPE,Bologna,105,106,211
2019,3,2019-03-12,LIPE,Bologna,93,92,185
2019,3,2019-03-13,LIPE,Bologna,97,98,195
2019,3,2019-03-14,LIPE,Bologna,103,103,206
2019,3,2019-03-15,LIPE,Bologna,108,107,215
2019,3,2019-03-16,LIPE,Bologna,92,91,183
2019,3,2019-03-17,LIPE,Bologna,90,90,180
2019,3,2019-03-18,LIPE,Bologna,108,108,216
2019,3,2019-03-19,LIPE,Bologna,97,96,193
2019,3,2019-03-20,LIPE,Bologna,103,100,203
2019,3,2019-03-21,LIPE,Bologna,98,101,199
2019,3,2019-03-22,LIPE,Bologna,106,104,210
2019,3,2019-03-23,LIPE,Bologna,85,86,171
2019,3,2019-03-24,LIPE,Bologna,90,95,185
2019,3,2019-03-25,LIPE,Bologna,95,97,192
2019,3,2019-03-26,LIPE,Bologna,100,98,198
2019,3,2019-03-27,LIPE,Bologna,102,98,200
2019,3,2019-03-28,LIPE,Bologna,101,101,202
2019,3,2019-03-29,LIPE,Bologna,103,107,210
2019,3,2019-03-30,LIPE,Bologna,84,85,169
2019,3,2019-03-31,LIPE,Bologna,103,99,202
2019,4,2019-04-01,LIPE,Bologna,113,111,224
2019,4,2019-04-02,LIPE,Bologna,108,107,215
2019,4,2019-04-03,LIPE,Bologna,105,107,212
2019,4,2019-04-04,LIPE,Bologna,115,114,229
2019,4,2019-04-05,LIPE,Bologna,116,114,230
2019,4,2019-04-06,LIPE,Bologna,96,94,190
2019,4,2019-04-07,LIPE,Bologna,101,106,207
2019,4,2019-04-08,LIPE,Bologna,111,111,222
2019,4,2019-04-09,LIPE,Bologna,110,110,220
2019,4,2019-04-10,LIPE,Bologna,108,106,214
2019,4,2019-04-11,LIPE,Bologna,111,113,224
2019,4,2019-04-12,LIPE,Bologna,110,114,224
2019,4,2019-04-13,LIPE,Bologna,103,99,202
2019,4,2019-04-14,LIPE,Bologna,108,112,220
2019,4,2019-04-15,LIPE,Bologna,108,109,217
2019,4,2019-04-16,LIPE,Bologna,113,108,221
2019,4,2019-04-17,LIPE,Bologna,108,112,220
2019,4,2019-04-18,LIPE,Bologna,115,112,227
2019,4,2019-04-19,LIPE,Bologna,120,122,242
2019,4,2019-04-20,LIPE,Bologna,100,99,199
2019,4,2019-04-21,LIPE,Bologna,97,97,194
2019,4,2019-04-22,LIPE,Bologna,104,104,208
2019,4,2019-04-23,LIPE,Bologna,115,115,230
2019,4,2019-04-24,LIPE,Bologna,110,110,220
2019,4,2019-04-25,LIPE,Bologna,107,106,213
2019,4,2019-04-26,LIPE,Bologna,116,117,233
2019,4,2019-04-27,LIPE,Bologna,99,99,198
2019,4,2019-04-28,LIPE,Bologna,106,110,216
2019,4,2019-04-29,LIPE,Bologna,111,107,218
2019,4,2019-04-30,LIPE,Bologna,111,111,222
2019,5,2019-05-01,LIPE,Bologna,105,109,214
2019,5,2019-05-02,LIPE,Bologna,116,116,232
2019,5,2019-05-03,LIPE,Bologna,117,118,235
2019,5,2019-05-04,LIPE,Bologna,104,102,206
2019,5,2019-05-05,LIPE,Bologna,109,111,220
2019,5,2019-05-06,LIPE,Bologna,113,111,224
2019,5,2019-05-07,LIPE,Bologna,110,112,222
2019,5,2019-05-08,LIPE,Bologna,110,110,220
2019,5,2019-05-09,LIPE,Bologna,107,106,213
2019,5,2019-05-10,LIPE,Bologna,115,118,233
2019,5,2019-05-11,LIPE,Bologna,113,112,225
2019,5,2019-05-12,LIPE,Bologna,113,109,222
2019,5,2019-05-13,LIPE,Bologna,114,112,226
2019,5,2019-05-14,LIPE,Bologna,104,107,211
2019,5,2019-05-15,LIPE,Bologna,114,114,228
2019,5,2019-05-16,LIPE,Bologna,113,113,226
2019,5,2019-05-17,LIPE,Bologna,113,115,228
2019,5,2019-05-18,LIPE,Bologna,106,101,207
2019,5,2019-05-19,LIPE,Bologna,106,111,217
2019,5,2019-05-20,LIPE,Bologna,119,113,232
2019,5,2019-05-21,LIPE,Bologna,76,75,151
2019,5,2019-05-22,LIPE,Bologna,112,114,226
2019,5,2019-05-23,LIPE,Bologna,108,111,219
2019,5,2019-05-24,LIPE,Bologna,114,114,228
2019,5,2019-05-25,LIPE,Bologna,105,103,208
2019,5,2019-05-26,LIPE,Bologna,105,105,210
2019,5,2019-05-27,LIPE,Bologna,115,112,227
2019,5,2019-05-28,LIPE,Bologna,107,110,217
2019,5,2019-05-29,LIPE,Bologna,121,122,243
2019,5,2019-05-30,LIPE,Bologna,115,123,238
2019,5,2019-05-31,LIPE,Bologna,125,122,247
2019,6,2019-06-01,LIPE,Bologna,109,105,214
2019,6,2019-06-02,LIPE,Bologna,113,114,227
2019,6,2019-06-03,LIPE,Bologna,121,119,240
2019,6,2019-06-04,LIPE,Bologna,113,113,226
2019,6,2019-06-05,LIPE,Bologna,110,110,220
2019,6,2019-06-06,LIPE,Bologna,119,118,237
2019,6,2019-06-07,LIPE,Bologna,115,117,232
2019,6,2019-06-08,LIPE,Bologna,108,111,219
2019,6,2019-06-09,LIPE,Bologna,108,115,223
2019,6,2019-06-10,LIPE,Bologna,122,113,235
2019,6,2019-06-11,LIPE,Bologna,112,111,223
2019,6,2019-06-12,LIPE,Bologna,116,117,233
2019,6,2019-06-13,LIPE,Bologna,119,114,233
2019,6,2019-06-14,LIPE,Bologna,116,119,235
2019,6,2019-06-15,LIPE,Bologna,107,106,213
2019,6,2019-06-16,LIPE,Bologna,113,120,233
2019,6,2019-06-17,LIPE,Bologna,122,117,239
2019,6,2019-06-18,LIPE,Bologna,114,115,229
2019,6,2019-06-19,LIPE,Bologna,116,113,229
2019,6,2019-06-20,LIPE,Bologna,116,116,232
2019,6,2019-06-21,LIPE,Bologna,120,122,242
2019,6,2019-06-22,LIPE,Bologna,109,108,217
2019,6,2019-06-23,LIPE,Bologna,120,126,246
2019,6,2019-06-24,LIPE,Bologna,126,119,245
2019,6,2019-06-25,LIPE,Bologna,113,113,226
2019,6,2019-06-26,LIPE,Bologna,120,120,240
2019,6,2019-06-27,LIPE,Bologna,117,118,235
2019,6,2019-06-28,LIPE,Bologna,131,133,264
2019,6,2019-06-29,LIPE,Bologna,119,113,232
2019,6,2019-06-30,LIPE,Bologna,122,127,249
2019,7,2019-07-01,LIPE,Bologna,128,122,250
2019,7,2019-07-02,LIPE,Bologna,111,118,229
2019,7,2019-07-03,LIPE,Bologna,125,120,245
2019,7,2019-07-04,LIPE,Bologna,116,122,238
2019,7,2019-07-05,LIPE,Bologna,126,127,253
2019,7,2019-07-06,LIPE,Bologna,113,109,222
2019,7,2019-07-07,LIPE,Bologna,128,127,255
2019,7,2019-07-08,LIPE,Bologna,127,125,252
2019,7,2019-07-09,LIPE,Bologna,111,112,223
2019,7,2019-07-10,LIPE,Bologna,117,119,236
2019,7,2019-07-11,LIPE,Bologna,122,120,242
2019,7,2019-07-12,LIPE,Bologna,121,125,246
2019,7,2019-07-13,LIPE,Bologna,119,115,234
2019,7,2019-07-14,LIPE,Bologna,117,122,239
2019,7,2019-07-15,LIPE,Bologna,127,120,247
2019,7,2019-07-16,LIPE,Bologna,113,115,228
2019,7,2019-07-17,LIPE,Bologna,114,116,230
2019,7,2019-07-18,LIPE,Bologna,113,114,227
2019,7,2019-07-19,LIPE,Bologna,125,123,248
2019,7,2019-07-20,LIPE,Bologna,106,105,211
2019,7,2019-07-21,LIPE,Bologna,115,123,238
2019,7,2019-07-22,LIPE,Bologna,122,119,241
2019,7,2019-07-23,LIPE,Bologna,114,115,229
2019,7,2019-07-24,LIPE,Bologna,118,120,238
2019,7,2019-07-25,LIPE,Bologna,113,118,231
2019,7,2019-07-26,LIPE,Bologna,119,119,238
2019,7,2019-07-27,LIPE,Bologna,115,110,225
2019,7,2019-07-28,LIPE,Bologna,122,130,252
2019,7,2019-07-29,LIPE,Bologna,133,121,254
2019,7,2019-07-30,LIPE,Bologna,113,113,226
2019,7,2019-07-31,LIPE,Bologna,113,117,230
2019,8,2019-08-01,LIPE,Bologna,108,109,217
2019,8,2019-08-02,LIPE,Bologna,117,114,231
2019,8,2019-08-03,LIPE,Bologna,113,110,223
2019,8,2019-08-04,LIPE,Bologna,119,120,239
2019,8,2019-08-05,LIPE,Bologna,120,116,236
2019,8,2019-08-06,LIPE,Bologna,113,112,225
2019,8,2019-08-07,LIPE,Bologna,114,109,223
2019,8,2019-08-08,LIPE,Bologna,108,109,217
2019,8,2019-08-09,LIPE,Bologna,113,117,230
2019,8,2019-08-10,LIPE,Bologna,112,109,221
2019,8,2019-08-11,LIPE,Bologna,114,116,230
2019,8,2019-08-12,LIPE,Bologna,118,116,234
2019,8,2019-08-13,LIPE,Bologna,107,104,211
2019,8,2019-08-14,LIPE,Bologna,106,107,213
2019,8,2019-08-15,LIPE,Bologna,101,102,203
2019,8,2019-08-16,LIPE,Bologna,105,108,213
2019,8,2019-08-17,LIPE,Bologna,113,110,223
2019,8,2019-08-18,LIPE,Bologna,111,115,226
2019,8,2019-08-19,LIPE,Bologna,114,109,223
2019,8,2019-08-20,LIPE,Bologna,103,105,208
2019,8,2019-08-21,LIPE,Bologna,112,109,221
2019,8,2019-08-22,LIPE,Bologna,102,104,206
2019,8,2019-08-23,LIPE,Bologna,109,109,218
2019,8,2019-08-24,LIPE,Bologna,107,105,212
2019,8,2019-08-25,LIPE,Bologna,119,125,244
2019,8,2019-08-26,LIPE,Bologna,121,114,235
2019,8,2019-08-27,LIPE,Bologna,107,108,215
2019,8,2019-08-28,LIPE,Bologna,119,119,238
2019,8,2019-08-29,LIPE,Bologna,113,112,225
2019,8,2019-08-30,LIPE,Bologna,113,116,229
2019,8,2019-08-31,LIPE,Bologna,110,111,221
2019,9,2019-09-01,LIPE,Bologna,120,124,244
2019,9,2019-09-02,LIPE,Bologna,127,123,250
2019,9,2019-09-03,LIPE,Bologna,121,122,243
2019,9,2019-09-04,LIPE,Bologna,131,132,263
2019,9,2019-09-05,LIPE,Bologna,126,129,255
2019,9,2019-09-06,LIPE,Bologna,123,122,245
2019,9,2019-09-07,LIPE,Bologna,124,116,240
2019,9,2019-09-08,LIPE,Bologna,131,133,264
2019,9,2019-09-09,LIPE,Bologna,123,123,246
2019,9,2019-09-10,LIPE,Bologna,118,119,237
2019,9,2019-09-11,LIPE,Bologna,117,119,236
2019,9,2019-09-12,LIPE,Bologna,123,121,244
2019,9,2019-09-13,LIPE,Bologna,123,130,253
2019,9,2019-09-14,LIPE,Bologna,115,110,225
2019,9,2019-09-15,LIPE,Bologna,122,127,249
2019,9,2019-09-16,LIPE,Bologna,121,116,237
2019,9,2019-09-17,LIPE,Bologna,117,117,234
2019,9,2019-09-18,LIPE,Bologna,116,119,235
2019,9,2019-09-19,LIPE,Bologna,116,116,232
2019,9,2019-09-20,LIPE,Bologna,123,124,247
2019,9,2019-09-21,LIPE,Bologna,113,105,218
2019,9,2019-09-22,LIPE,Bologna,121,129,250
2019,9,2019-09-23,LIPE,Bologna,132,125,257
2019,9,2019-09-24,LIPE,Bologna,117,120,237
2019,9,2019-09-25,LIPE,Bologna,126,125,251
2019,9,2019-09-26,LIPE,Bologna,118,119,237
2019,9,2019-09-27,LIPE,Bologna,123,125,248
2019,9,2019-09-28,LIPE,Bologna,118,109,227
2019,9,2019-09-29,LIPE,Bologna,114,117,231
2019,9,2019-09-30,LIPE,Bologna,119,119,238
2019,10,2019-10-01,LIPE,Bologna,109,108,217
2019,10,2019-10-02,LIPE,Bologna,114,109,223
2019,10,2019-10-03,LIPE,Bologna,102,103,205
2019,10,2019-10-04,LIPE,Bologna,114,116,230
2019,10,2019-10-05,LIPE,Bologna,101,98,199
2019,10,2019-10-06,LIPE,Bologna,107,109,216
2019,10,2019-10-07,LIPE,Bologna,115,111,226
2019,10,2019-10-08,LIPE,Bologna,104,106,210
2019,10,2019-10-09,LIPE,Bologna,108,110,218
2019,10,2019-10-10,LIPE,Bologna,101,102,203
2019,10,2019-10-11,LIPE,Bologna,113,118,231
2019,10,2019-10-12,LIPE,Bologna,105,98,203
2019,10,2019-10-13,LIPE,Bologna,108,111,219
2019,10,2019-10-14,LIPE,Bologna,115,115,230
2019,10,2019-10-15,LIPE,Bologna,111,105,216
2019,10,2019-10-16,LIPE,Bologna,110,109,219
2019,10,2019-10-17,LIPE,Bologna,105,106,211
2019,10,2019-10-18,LIPE,Bologna,111,112,223
2019,10,2019-10-19,LIPE,Bologna,105,100,205
2019,10,2019-10-20,LIPE,Bologna,104,110,214
2019,10,2019-10-21,LIPE,Bologna,110,109,219
2019,10,2019-10-22,LIPE,Bologna,106,106,212
2019,10,2019-10-23,LIPE,Bologna,111,106,217
2019,10,2019-10-24,LIPE,Bologna,105,109,214
2019,10,2019-10-25,LIPE,Bologna,82,84,166
2019,10,2019-10-26,LIPE,Bologna,99,98,197
2019,10,2019-10-27,LIPE,Bologna,99,99,198
2019,10,2019-10-28,LIPE,Bologna,118,112,230
2019,10,2019-10-29,LIPE,Bologna,104,106,210
2019,10,2019-10-30,LIPE,Bologna,97,94,191
2019,10,2019-10-31,LIPE,Bologna,102,103,205
2019,11,2019-11-01,LIPE,Bologna,99,99,198
2019,11,2019-11-02,LIPE,Bologna,85,85,170
2019,11,2019-11-03,LIPE,Bologna,96,103,199
2019,11,2019-11-04,LIPE,Bologna,112,112,224
2019,11,2019-11-05,LIPE,Bologna,102,102,204
2019,11,2019-11-06,LIPE,Bologna,93,92,185
2019,11,2019-11-07,LIPE,Bologna,98,97,195
2019,11,2019-11-08,LIPE,Bologna,110,110,220
2019,11,2019-11-09,LIPE,Bologna,89,88,177
2019,11,2019-11-10,LIPE,Bologna,102,104,206
2019,11,2019-11-11,LIPE,Bologna,110,112,222
2019,11,2019-11-12,LIPE,Bologna,97,92,189
2019,11,2019-11-13,LIPE,Bologna,91,89,180
2019,11,2019-11-14,LIPE,Bologna,103,102,205
2019,11,2019-11-15,LIPE,Bologna,119,122,241
2019,11,2019-11-16,LIPE,Bologna,87,84,171
2019,11,2019-11-17,LIPE,Bologna,94,93,187
2019,11,2019-11-18,LIPE,Bologna,108,114,222
2019,11,2019-11-19,LIPE,Bologna,97,94,191
2019,11,2019-11-20,LIPE,Bologna,89,90,179
2019,11,2019-11-21,LIPE,Bologna,96,93,189
2019,11,2019-11-22,LIPE,Bologna,109,111,220
2019,11,2019-11-23,LIPE,Bologna,85,85,170
2019,11,2019-11-24,LIPE,Bologna,91,90,181
2019,11,2019-11-25,LIPE,Bologna,99,100,199
2019,11,2019-11-26,LIPE,Bologna,94,93,187
2019,11,2019-11-27,LIPE,Bologna,89,91,180
2019,11,2019-11-28,LIPE,Bologna,95,94,189
2019,11,2019-11-29,LIPE,Bologna,114,112,226
2019,11,2019-11-30,LIPE,Bologna,86,85,171
2019,12,2019-12-01,LIPE,Bologna,94,96,190
2019,12,2019-12-02,LIPE,Bologna,114,112,226
2019,12,2019-12-03,LIPE,Bologna,102,99,201
2019,12,2019-12-04,LIPE,Bologna,91,87,178
2019,12,2019-12-05,LIPE,Bologna,90,96,186
2019,12,2019-12-06,LIPE,Bologna,104,106,210
2019,12,2019-12-07,LIPE,Bologna,92,84,176
2019,12,2019-12-08,LIPE,Bologna,87,93,180
2019,12,2019-12-09,LIPE,Bologna,115,113,228
2019,12,2019-12-10,LIPE,Bologna,91,92,183
2019,12,2019-12-11,LIPE,Bologna,89,89,178
2019,12,2019-12-12,LIPE,Bologna,91,92,183
2019,12,2019-12-13,LIPE,Bologna,92,92,184
2019,12,2019-12-14,LIPE,Bologna,84,83,167
2019,12,2019-12-15,LIPE,Bologna,91,95,186
2019,12,2019-12-16,LIPE,Bologna,109,105,214
2019,12,2019-12-17,LIPE,Bologna,90,94,184
2019,12,2019-12-18,LIPE,Bologna,98,99,197
2019,12,2019-12-19,LIPE,Bologna,117,112,229
2019,12,2019-12-20,LIPE,Bologna,115,116,231
2019,12,2019-12-21,LIPE,Bologna,107,104,211
2019,12,2019-12-22,LIPE,Bologna,95,96,191
2019,12,2019-12-23,LIPE,Bologna,111,105,216
2019,12,2019-12-24,LIPE,Bologna,76,76,152
2019,12,2019-12-25,LIPE,Bologna,34,35,69
2019,12,2019-12-26,LIPE,Bologna,93,93,186
2019,12,2019-12-27,LIPE,Bologna,100,101,201
2019,12,2019-12-28,LIPE,Bologna,91,90,181
2019,12,2019-12-29,LIPE,Bologna,89,92,181
2019,12,2019-12-30,LIPE,Bologna,108,105,213
2019,12,2019-12-31,LIPE,Bologna,77,77,154
